            ###################
            #       #         ####################################
            #   #  E#                                            #
            #   #####         ################################## #
            #                 #                                # #
############################  #################                # #
#                                             #                # #
#       ##################                    #                # #
#                        #####                #                # #
#      ###############       #                #                # #
#      #                     #                #                # #
###################  ##########################                # #
                #                       #                      # #
                #             #     #   ######################## #
                #             #     #   #                        #
                ############  #     #   ##########################
                #             #     #   #
                #             #######   #
                #             #     #   #
                #             #     #   #
                #             #     #  S#
                #########################
